1 5 5 5 5 5 5 5 5 5 5 5 5 5 5 5 5 5 5 5 5 2
6 0 0 0 0 0 0 0 0 0 0 0 0 0 0 0 0 0 0 0 0 6
6 0 1 5 5 5 5 5 5 5 5 2 0 0 0 0 0 0 0 0 0 6
6 0 6 7 7 7 7 7 7 7 7 6 0 0 0 0 0 0 0 0 0 6
6 0 6 7 7 7 7 7 7 7 7 6 0 0 0 0 0 0 6 0 0 6
6 0 6 7 7 7 7 7 7 7 7 0 0 0 0 0 0 0 0 0 0 6
6 0 6 7 7 7 7 7 7 7 7 6 0 0 0 0 0 0 0 0 0 6
6 0 6 7 7 7 7 7 7 7 7 6 0 0 0 0 0 0 0 0 0 6
6 0 3 5 5 5 5 5 5 5 5 4 0 0 0 0 0 0 0 0 0 6
6 0 0 0 0 0 0 0 0 0 0 0 0 0 0 0 0 0 0 0 0 6
6 0 0 0 0 0 0 0 0 0 0 0 0 0 0 0 0 0 0 0 0 6
6 0 0 0 0 0 0 0 0 0 0 0 0 0 0 0 0 0 0 0 0 6
6 0 0 0 0 0 0 0 0 0 0 0 0 0 0 0 0 0 0 0 0 6
6 0 0 0 0 0 0 0 0 0 0 0 0 0 0 0 0 0 0 0 0 6
6 0 0 0 0 0 0 0 0 0 0 0 0 0 0 0 0 0 0 0 0 6
6 0 0 0 0 0 0 0 0 0 0 0 0 0 0 0 0 0 0 0 0 6
3 5 5 5 5 5 5 5 5 5 5 5 5 5 5 5 5 5 5 5 5 4